# ref
えー	(ええ)
まー	(まあ)
ユーザ	(ユーザー)
ビリティ	(ビリティー)
調査する	(ちょうさする)
諸注	(しょちゅう)
兼ね合い	(かねあい)

# whisper
パーセント	(%)
Web	(ウェブ|ウエブ)

# nue
はじめ	(初めに)
やなぎさん	(柳さん)

# reazon
立て付け	(立てつけ)
やなさん	(ヤナさん)
えもとさん	(江本さん)

# espnet
やませ	(山瀬)
やまうち	(山内)
やの	(矢野)
も一つ	(もひとつ)
みやざき	(みやざき)
やまもと	(山本)

# sasr
一つ目	(ひとつ目)
uding	(ユーディング)
23	(二三)
先ほど	(さきほど)
&	(アンド)
